1 1 1 1 1 1 1 1 1 1 1 1 1 1 1 1 1 1 1 1 1 1 1 1 1 1 1 1
1 2 2 2 2 2 2 2 2 2 2 2 2 1 1 2 2 2 2 2 2 2 2 2 2 2 2 1
1 2 1 1 1 1 2 1 1 2 1 1 2 1 1 2 1 1 2 1 1 2 1 1 1 1 2 1
1 3 1 1 1 1 2 1 1 2 1 1 2 1 1 2 1 1 2 1 1 2 1 1 1 1 3 1
1 2 2 2 2 2 2 2 2 2 1 1 2 2 2 2 1 1 2 2 2 2 2 2 2 2 2 1
1 2 1 1 2 1 1 1 1 2 1 1 2 1 1 2 1 1 2 1 1 1 1 2 1 1 2 1
1 2 1 1 2 1 1 2 2 2 2 2 2 1 1 2 2 2 2 2 2 1 1 2 1 1 2 1
1 2 1 1 2 1 1 2 1 1 1 1 2 2 2 2 1 1 1 1 2 1 1 2 1 1 2 1
1 2 2 2 2 2 2 2 2 3 2 2 2 1 1 2 2 2 3 2 2 2 2 2 2 2 2 1
1 2 1 1 2 1 1 2 1 1 1 1 0 1 1 0 1 1 1 1 2 1 1 2 1 1 2 1
1 2 1 1 2 1 1 2 1 1 1 1 0 1 1 0 1 1 1 1 2 1 1 2 1 1 2 1
1 2 2 2 2 1 1 2 1 0 0 0 0 0 0 0 0 0 0 1 2 1 1 2 2 2 2 1
1 1 1 1 2 2 2 2 1 0 1 1 1 4 4 1 1 1 0 1 2 2 2 2 1 1 1 1
1 1 1 1 1 1 1 2 1 0 1 4 4 4 4 4 4 1 0 1 2 1 1 1 1 1 1 1
5 0 0 0 0 0 0 2 0 0 1 4 4 4 4 4 4 1 0 0 2 0 0 0 0 0 0 5
1 1 1 1 1 1 1 2 1 0 1 4 4 4 4 4 4 1 0 1 2 1 1 1 1 1 1 1
1 1 1 2 2 2 2 2 1 0 1 1 1 1 1 1 1 1 0 1 2 2 2 2 2 1 1 1
1 2 2 2 1 1 1 2 1 0 0 0 0 0 0 0 0 0 0 1 2 1 1 1 2 2 2 1
1 2 1 1 1 1 1 2 1 0 1 1 1 1 1 1 1 1 0 1 2 1 1 1 1 1 2 1
1 2 1 1 1 1 1 2 1 2 2 2 2 2 2 2 2 2 2 1 2 1 1 1 1 1 2 1
1 2 2 2 2 2 2 2 2 2 1 1 1 1 1 1 1 1 2 2 2 2 2 2 2 2 2 1
1 2 1 1 1 1 2 1 1 2 2 2 2 1 1 2 2 2 2 1 1 2 1 1 1 1 2 1
1 2 1 1 1 1 2 1 1 1 1 1 2 1 1 2 1 1 1 1 1 2 1 1 1 1 2 1
1 3 2 2 2 2 2 2 2 2 2 2 2 2 2 2 2 2 2 2 2 2 2 2 2 2 3 1
1 1 1 2 1 1 2 1 1 2 1 1 1 1 1 1 1 1 2 1 1 2 1 1 2 1 1 1
1 1 1 2 1 1 2 1 1 2 2 2 2 2 2 2 2 2 2 1 1 2 1 1 2 1 1 1
1 2 2 2 2 2 2 1 1 3 1 1 1 1 1 1 1 1 3 1 1 2 2 2 2 2 2 1
1 2 1 1 1 1 2 1 1 2 2 2 2 2 2 2 2 2 2 1 1 2 1 1 1 1 2 1
1 2 1 1 1 1 2 1 1 1 1 1 2 1 1 2 1 1 1 1 1 2 1 1 1 1 2 1
1 2 2 2 2 2 2 2 2 2 2 2 2 1 1 2 2 2 2 2 2 2 2 2 2 2 2 1
1 1 1 1 1 1 1 1 1 1 1 1 1 1 1 1 1 1 1 1 1 1 1 1 1 1 1 1
